################################################################################
#
#       ########
#       ########
#
#                                       ########
#                                       ########
#
#
#                                                                       ########
#############                                                           ########
#############
#
#
#                  ################
#                  ################
#                  ################
#
#
#
################################################################################
